size: 22, 14
######################
#....>>oo....#########
#....^>>^....#.......#
#............#.......#
#...#...##...#.......#
#.......p#.>o#>>>0...#
#..........o^#lll^...#
#..........^^#lll^...#
#...#......lo#lll^...#
#...##...#...#########
#............#########
#............#########
#............#########
######################
