size: 17, 12
#################
#o.>o.>o...#>>>o#
#^..^.^....#lll^#
#lo.^.^....#lll^#
#.......o..#lll^#
#.......l>o#....#
#....p.....#...@#
#.......>>o######
#.......^..######
#.........o######
#.......>>^######
#################
