size: 19, 14
###################
#....>>oo....#oooo#
#....^>>^....#^^^^#
#............#^^^^#
#...#...##...#^^^^#
#........#.>o#...@#
#......p...o^#....#
#..........^^#....#
#...#......lo#....#
#...##...#...######
#............######
#............######
#............######
###################
