size: 17, 12
#################
#..........###.@#
#.o..p..>o.#..>o#
#.lo.......#>>l^#
#.^..>o....#l^###
#.....^....######
#..........######
##..####...#...##
#>o>>o.#...#>>o##
#^ol^.##....o^o##
#^lolo.#....l>^##
#################
