size: 17, 12
#################
#..........#...@#
#.o..p..>o.#....#
#.lo.......#>>>o#
#.^..>o....#lll^#
#.....^....#lll^#
#..........######
##..####...#...##
#>o>>o.#...#>>o##
#^ol^.##....o^o##
#^lolo.#....l>^##
#################
