size: 18, 12
##################
#..........##....#
#.o..p..>o.#.>>>o#
#.lo.......#.lll^#
#.^..>o....#.lll^#
#.....^....#.lll2#
#..........#######
##..####...#...###
#oo>>o.#...#>>o###
#o^l^.##....o^o###
#^lolo.#....l>^###
##################
