size: 15, 12
###############
#>>o.#oo..#>>o#
#3l^.#^^.....^#
#ll^.#.......^#
######.......##
##...........##
##.....p.....##
##...........##
###o.......o###
##>lo.....>lo##
##l^#.....#l^##
###############
