size: 14, 7
##############
#p.>o..#######
#.#^...#>o.###
#.####.#l^..@#
#>>o..o##^.###
###..#^#######
##############
