size: 13, 11
#############
#...#>>o....#
#.p..^.^....#
#...#l>^....#
#o.######...#
#..ooo......#
#..o.o......#
#.#ooo.....@#
#.##.########
#....########
#############
