size: 9, 7
#########
#.......#
#.#####.#
#.#@.p#.#
#.##.##.#
#..#....#
#########
