size: 10, 7
##########
#p...>>o.#
#....^.^.#
#...>l>^.#
#.>o..o..#
#.^o.o^.@#
##########
