size: 7, 6
#######
#p....#
#.#.@.#
#.###.#
#.....#
#######
