size: 15, 6
###############
#p...#>>o#....#
#.>o.#^..#.>o.#
#.l^.#.###.^o.#
#....#..@#....#
###############
