size: 17, 12
#################
#########...#.@.#
######o##.#.#.#.#
#...#...#...#...#
#>oo#>>o#o>o#.o.#
#^>^#ll^#lo^#>lo#
#...#...#...#ll^#
##.###.###.######
#.............o.#
#.....p.......^.#
#............>lo#
#################
