size: 17, 9
#################
######o##########
#...#...#...#####
#>oo#>>o#o>o##@##
#^>^#ll^#lo^##.##
#...#...#...#.o.#
##.###.###.##>lo#
##....p....##ll^#
#################
