size: 17, 11
#################
######o##########
#...#...#...#####
#>oo#>>o#o>o#####
#^>^#ll^#lo^#.@.#
#...#...#...#.#.#
##.###.###.##...#
#.........o.#.o.#
#.....p...^.#>lo#
#........>lo#ll^#
#################
