size: 15, 11
###############
#......#o..#..#
#.##....^.....#
#..#####^..#..#
#>o#...#^..#..#
#l^..p..^.....#
#..#...#^..#..#
#..#####^..####
#.##....^.....#
#......#^..#.@#
###############
