size: 15, 13
###############
#......#o..#..#
#.##....^.....#
#..#...#^..#..#
#..#####^..#..#
#>o#...#^..#..#
#l^..p..^.....#
#l^#...#^..#..#
#..#####^..####
#..#...#^..#..#
#.##....^....@#
#......#^..#..#
###############
