size: 13, 8
#############
#...........#
#.>>o###>>o.#
#.^.^.@#^...#
#.l>^###l>o.#
#.....o.....#
######p######
#############
