size: 14, 9
##############
#o....####>>o#
#.....>>o#^..#
#........#.###
#....p...#@#o#
##o......#####
##^......#####
##^......#####
##############
