size: 20, 13
####################
###.>o.#..@.#o.....#
##..^..#.##.#^####.#
##.###.#.>o.#.o....#
##.o.o.#.l^.#.lo...#
##.l>^.###^####lo..#
###.#.##....###.####
#..................#
#............p.....#
#....o..#..#.......#
#....lo......>o....#
#..................#
####################
