size: 14, 14
##############
#####...######
#####.p.######
#####...#....#
######.##.##.#
#...#>>o...#.#
#.@..ll^.....#
#...#ll^...###
#####......###
###..........#
###.#......#.#
###.##.##.##.#
###....##....#
##############
