size: 14, 10
##############
#####...######
#####.@.######
#####...##...#
######.###.#.#
#...#>>o.....#
#.p..ll^....##
#...#####.#.##
#########...##
##############
