size: 13, 11
#############
#...#>>o....#
#.p..ll^....#
#...#ll^....#
#########...#
###.........#
#...........#
#.#........@#
#.##.########
#....########
#############
