size: 13, 13
#############
####.p.######
####...#....#
#####.##.##.#
#..#>>o...#.#
#@..ll^.....#
#..#ll^...###
####......###
##..........#
##.#......#.#
##.##.##.##.#
##....##....#
#############
