size: 18, 13
##################
#.....##o.>o..####
#.....####l^>o####
#.....####^ol^####
#.>>o.#...>lo^...#
#.ll^.#.########.#
#.l3^.#..........#
#.ll^.#...p...>o.#
#.ll^.#.>o.o...^.#
#.....#.^..lo.o..#
#.....#.^...^.lo.#
#.....#..........#
##################
