size: 17, 7
#################
######p......#>o#
#...o#.ooo.#...^#
#.>>^#.ooo.######
#>^.@#.ooo...#>o#
######.....#..l^#
#################
