size: 18, 5
##################
##>>o...........##
#p^.^...........@#
##l>^...........##
##################
